//MAP CONVERTED BY dmm2tgm.py THIS HEADER COMMENT PREVENTS RECONVERSION, DO NOT REMOVE
"a" = (
/turf/template_noop,
/area/template_noop)
"b" = (
/obj/effect/turf_decal/tile/dark_red{
	dir = 8
	},
/turf/open/floor/iron/dark/smooth_edge{
	dir = 1
	},
/area/ruin/syndicate_lava_base/telecomms)
"g" = (
/obj/structure/table,
/obj/item/papercutter,
/obj/effect/turf_decal/siding/thinplating_new{
	dir = 5
	},
/turf/open/floor/mineral/titanium/tiled,
/area/ruin/syndicate_lava_base/telecomms)
"h" = (
/obj/machinery/airalarm/syndicate{
	dir = 4;
	pixel_x = 24
	},
/obj/structure/rack,
/obj/item/storage/toolbox/syndicate,
/obj/item/multitool,
/turf/open/floor/catwalk_floor/iron_dark,
/area/ruin/syndicate_lava_base/telecomms)
"i" = (
/obj/effect/turf_decal/siding/thinplating_new/dark{
	dir = 6
	},
/obj/structure/table/reinforced/plastitaniumglass,
/obj/item/folder/red{
	pixel_y = 1
	},
/obj/item/folder/blue{
	pixel_y = 2
	},
/turf/open/floor/mineral/plastitanium,
/area/ruin/syndicate_lava_base/telecomms)
"j" = (
/obj/effect/turf_decal/tile/red{
	dir = 4
	},
/obj/structure/cable,
/obj/machinery/atmospherics/pipe/smart/manifold4w/scrubbers/hidden/layer4{
	dir = 4
	},
/obj/machinery/atmospherics/pipe/smart/manifold4w/supply/hidden/layer2,
/turf/open/floor/iron/edge,
/area/ruin/syndicate_lava_base/telecomms)
"k" = (
/turf/closed/wall/mineral/plastitanium/nodiagonal,
/area/ruin/syndicate_lava_base/telecomms)
"l" = (
/obj/effect/turf_decal/tile/dark_red{
	dir = 8
	},
/obj/machinery/atmospherics/components/unary/vent_scrubber/on/layer4,
/turf/open/floor/iron/dark/smooth_edge{
	dir = 1
	},
/area/ruin/syndicate_lava_base/telecomms)
"q" = (
/obj/structure/closet/crate/secure/freezer/commsagent,
/obj/machinery/light/small/directional/north,
/obj/effect/turf_decal/siding/dark,
/turf/open/floor/plating/elevatorshaft,
/area/ruin/syndicate_lava_base/telecomms)
"s" = (
/obj/structure/filingcabinet/security,
/obj/effect/turf_decal/tile/red/diagonal_centre,
/obj/effect/turf_decal/siding/thinplating_new{
	dir = 8
	},
/obj/machinery/firealarm/directional/west,
/turf/open/floor/mineral/titanium/tiled,
/area/ruin/syndicate_lava_base/telecomms)
"t" = (
/obj/effect/turf_decal/tile/dark_red{
	dir = 8
	},
/obj/machinery/light/directional/east,
/turf/open/floor/iron/dark/smooth_edge{
	dir = 1
	},
/area/ruin/syndicate_lava_base/telecomms)
"u" = (
/obj/machinery/power/apc/syndicate{
	name = "Telecommunications APC";
	pixel_y = -25
	},
/obj/structure/cable,
/turf/open/floor/catwalk_floor/iron,
/area/ruin/syndicate_lava_base/telecomms)
"x" = (
/obj/machinery/computer/med_data{
	dir = 4
	},
/obj/effect/turf_decal/tile/blue/diagonal_centre,
/obj/effect/turf_decal/siding/thinplating_new/dark{
	dir = 10
	},
/turf/open/floor/mineral/plastitanium,
/area/ruin/syndicate_lava_base/telecomms)
"y" = (
/obj/effect/turf_decal/tile/red{
	dir = 4
	},
/obj/machinery/atmospherics/pipe/smart/manifold4w/scrubbers/hidden/layer4{
	dir = 4
	},
/obj/machinery/atmospherics/pipe/smart/manifold4w/supply/hidden/layer2,
/turf/open/floor/iron/edge,
/area/ruin/syndicate_lava_base/telecomms)
"z" = (
/obj/structure/chair/office/tactical,
/obj/machinery/atmospherics/components/unary/vent_scrubber/on/layer4{
	dir = 4
	},
/turf/open/floor/iron/large,
/area/ruin/syndicate_lava_base/telecomms)
"D" = (
/obj/machinery/computer/camera_advanced{
	dir = 4
	},
/obj/effect/turf_decal/tile/dark_red/half/contrasted{
	dir = 8
	},
/obj/item/radio/intercom/directional/north{
	freerange = 1;
	name = "Syndicate Radio Intercomm"
	},
/obj/machinery/light/directional/west,
/turf/open/floor/iron/edge{
	dir = 4
	},
/area/ruin/syndicate_lava_base/telecomms)
"F" = (
/obj/machinery/button/door{
	id = "lavalandsyndi_telecomms";
	name = "Telecomms Blast Door Control";
	pixel_x = -26;
	req_access = list("syndicate")
	},
/obj/effect/turf_decal/siding/thinplating_new/dark{
	dir = 8
	},
/obj/machinery/computer/terminal/lavaland_syndicate/cracked_security_records{
	dir = 4
	},
/obj/effect/decal/cleanable/cobweb,
/obj/effect/decal/cleanable/dirt/dust,
/obj/effect/turf_decal/tile/red/diagonal_centre,
/turf/open/floor/mineral/plastitanium,
/area/ruin/syndicate_lava_base/telecomms)
"H" = (
/obj/machinery/telecomms/relay/preset/ruskie{
	use_power = 0
	},
/obj/effect/turf_decal/tile/dark/half/contrasted{
	dir = 8
	},
/obj/effect/turf_decal/siding/dark{
	dir = 4
	},
/turf/open/floor/circuit/red,
/area/ruin/syndicate_lava_base/telecomms)
"J" = (
/obj/machinery/door/airlock/highsecurity{
	name = "Primary Mission Equipment"
	},
/obj/effect/mapping_helpers/airlock/access/all/syndicate/general,
/turf/open/floor/iron/dark/side{
	dir = 1
	},
/area/ruin/syndicate_lava_base/telecomms)
"K" = (
/obj/effect/spawner/structure/window/reinforced/plasma/plastitanium,
/obj/machinery/door/poddoor/preopen{
	id = "lavalandsyndi_telecomms"
	},
/turf/open/floor/plating,
/area/ruin/syndicate_lava_base/telecomms)
"L" = (
/obj/machinery/computer/message_monitor{
	dir = 1
	},
/obj/effect/turf_decal/tile/dark_red/half/contrasted,
/obj/structure/noticeboard/directional/south,
/turf/open/floor/iron/edge{
	dir = 1
	},
/area/ruin/syndicate_lava_base/telecomms)
"M" = (
/obj/item/storage/secure/safe/directional/south,
/obj/effect/turf_decal/tile/dark_red/opposingcorners{
	dir = 1
	},
/turf/open/floor/mineral/titanium/tiled,
/area/ruin/syndicate_lava_base/telecomms)
"Q" = (
/obj/structure/filingcabinet/medical,
/obj/effect/turf_decal/tile/blue/diagonal_centre,
/obj/effect/turf_decal/siding/thinplating_new{
	dir = 9
	},
/turf/open/floor/mineral/titanium/tiled,
/area/ruin/syndicate_lava_base/telecomms)
"R" = (
/obj/structure/sign/poster/contraband/random/directional/east,
/turf/open/floor/iron/dark/textured_large,
/area/ruin/syndicate_lava_base/telecomms)
"S" = (
/obj/effect/turf_decal/siding/thinplating_new/dark,
/turf/open/floor/mineral/plastitanium,
/area/ruin/syndicate_lava_base/telecomms)
"T" = (
/obj/effect/turf_decal/siding/thinplating_new{
	dir = 1
	},
/turf/open/floor/mineral/titanium/tiled,
/area/ruin/syndicate_lava_base/telecomms)
"U" = (
/obj/machinery/door/airlock/hatch{
	name = "Telecommunications"
	},
/obj/effect/mapping_helpers/airlock/access/all/syndicate/general,
/obj/modular_map_connector,
/obj/structure/cable,
/obj/machinery/atmospherics/pipe/smart/manifold4w/scrubbers/hidden/layer4{
	dir = 4
	},
/obj/machinery/atmospherics/pipe/smart/manifold4w/supply/hidden/layer2,
/turf/open/floor/iron/large,
/area/ruin/syndicate_lava_base/telecomms)
"V" = (
/obj/machinery/photocopier,
/obj/effect/turf_decal/siding/thinplating_new{
	dir = 4
	},
/turf/open/floor/mineral/titanium/tiled,
/area/ruin/syndicate_lava_base/telecomms)
"W" = (
/obj/structure/table/reinforced,
/obj/structure/window/reinforced/survival_pod/spawner/east,
/obj/effect/turf_decal/tile/dark_red{
	dir = 8
	},
/obj/item/paper_bin{
	pixel_y = 3;
	pixel_x = 6
	},
/obj/item/pen,
/turf/open/floor/iron/corner{
	dir = 8
	},
/area/ruin/syndicate_lava_base/telecomms)
"X" = (
/obj/machinery/door/window/survival_pod{
	dir = 4
	},
/obj/machinery/newscaster/directional/north,
/obj/machinery/atmospherics/pipe/smart/manifold4w/scrubbers/hidden/layer4{
	dir = 4
	},
/obj/machinery/atmospherics/components/unary/vent_pump/on/layer2{
	dir = 4
	},
/turf/open/floor/iron/large,
/area/ruin/syndicate_lava_base/telecomms)
"Y" = (
/obj/structure/chair/office/tactical{
	dir = 8
	},
/obj/effect/turf_decal/tile/dark_red/opposingcorners,
/turf/open/floor/mineral/plastitanium,
/area/ruin/syndicate_lava_base/telecomms)
"Z" = (
/obj/effect/turf_decal/tile/dark_red{
	dir = 8
	},
/obj/machinery/atmospherics/components/unary/vent_pump/on/layer2,
/turf/open/floor/iron/dark/smooth_edge{
	dir = 1
	},
/area/ruin/syndicate_lava_base/telecomms)

(1,1,1) = {"
a
k
k
k
k
k
a
a
"}
(2,1,1) = {"
k
k
H
k
D
k
k
a
"}
(3,1,1) = {"
k
q
R
J
z
L
k
a
"}
(4,1,1) = {"
k
k
k
k
X
W
k
k
"}
(5,1,1) = {"
K
F
x
b
y
Q
s
k
"}
(6,1,1) = {"
K
Y
S
Z
y
T
M
k
"}
(7,1,1) = {"
K
K
i
l
y
g
V
k
"}
(8,1,1) = {"
a
K
h
t
j
u
k
k
"}
(9,1,1) = {"
a
a
a
a
U
a
a
a
"}
