//MAP CONVERTED BY dmm2tgm.py THIS HEADER COMMENT PREVENTS RECONVERSION, DO NOT REMOVE
"aA" = (
/turf/template_noop,
/area/template_noop)
"aU" = (
/obj/machinery/atmospherics/pipe/smart/manifold4w/supply/hidden,
/obj/machinery/light/small/directional/south,
/turf/open/floor/catwalk_floor/iron_dark,
/area/ruin/syndicate_lava_base/testlab)
"be" = (
/obj/machinery/power/apc/auto_name/directional/south{
	req_access = list("syndicate")
	},
/obj/structure/cable,
/obj/effect/turf_decal/siding/dark_red{
	dir = 1
	},
/obj/effect/turf_decal/tile/neutral{
	dir = 8
	},
/turf/open/floor/iron/dark,
/area/ruin/syndicate_lava_base/testlab)
"bp" = (
/obj/structure/cable,
/obj/effect/turf_decal/tile/neutral/half,
/turf/open/floor/iron/dark/smooth_half,
/area/ruin/syndicate_lava_base/testlab)
"bs" = (
/obj/machinery/button/door{
	id = "lavalandsyndi_mistake";
	name = "Chemistry Blast Door Control";
	pixel_y = 26;
	req_access = list("syndicate")
	},
/obj/effect/turf_decal/stripes/line{
	dir = 8
	},
/obj/machinery/atmospherics/pipe/smart/manifold4w/green/visible,
/turf/open/floor/engine,
/area/ruin/syndicate_lava_base/testlab)
"dO" = (
/obj/structure/sign/warning/explosives/alt/directional/west,
/obj/machinery/atmospherics/components/tank/nitrogen{
	dir = 4;
	initialize_directions = 4
	},
/obj/effect/turf_decal/stripes/line{
	dir = 5
	},
/obj/effect/turf_decal/stripes/red/line{
	dir = 10
	},
/turf/open/floor/iron/dark/textured,
/area/ruin/syndicate_lava_base/testlab)
"ef" = (
/obj/machinery/atmospherics/pipe/smart/manifold4w/supply/hidden,
/obj/machinery/atmospherics/pipe/smart/manifold4w/scrubbers/hidden/layer4,
/obj/structure/cable,
/turf/open/floor/catwalk_floor/iron_dark,
/area/ruin/syndicate_lava_base/testlab)
"em" = (
/turf/closed/wall/mineral/plastitanium/nodiagonal,
/area/ruin/syndicate_lava_base/testlab)
"eq" = (
/obj/machinery/door/airlock/engineering{
	name = "Supermatter"
	},
/obj/effect/mapping_helpers/airlock/access/all/syndicate/general,
/turf/open/floor/iron/dark,
/area/ruin/syndicate_lava_base/testlab)
"eZ" = (
/obj/structure/table/reinforced,
/obj/item/paper_bin,
/obj/item/pen,
/obj/effect/turf_decal/tile/neutral{
	dir = 1
	},
/turf/open/floor/iron/dark/textured,
/area/ruin/syndicate_lava_base/testlab)
"fY" = (
/obj/machinery/power/energy_accumulator/grounding_rod/anchored,
/obj/structure/cable/multilayer/connected,
/turf/open/floor/engine,
/area/ruin/syndicate_lava_base/testlab)
"gJ" = (
/obj/structure/table/reinforced,
/obj/item/paper/crumpled{
	default_raw_text = "Explosive testing on site is STRICTLY forbidden, as this outpost's walls are lined with explosives intended for intentional self-destruct purposes that may be set off prematurely through careless experiments.";
	name = "Explosives Testing Warning";
	pixel_x = -6;
	pixel_y = 5
	},
/obj/item/clothing/glasses/meson{
	pixel_y = 8
	},
/obj/item/clothing/glasses/meson{
	pixel_y = 5
	},
/obj/item/clothing/glasses/meson,
/obj/effect/turf_decal/tile/neutral{
	dir = 8
	},
/turf/open/floor/iron/dark/textured,
/area/ruin/syndicate_lava_base/testlab)
"gX" = (
/obj/machinery/airalarm/directional/north{
	req_access = list("syndicate")
	},
/obj/item/stock_parts/matter_bin/bluespace,
/obj/item/stock_parts/matter_bin/bluespace,
/obj/item/stock_parts/matter_bin/bluespace,
/obj/item/stock_parts/matter_bin/bluespace,
/obj/item/stock_parts/matter_bin/bluespace,
/obj/item/stock_parts/matter_bin/bluespace,
/obj/item/stock_parts/micro_laser/quadultra,
/obj/item/stock_parts/micro_laser/quadultra,
/obj/item/stock_parts/micro_laser/quadultra,
/obj/item/stock_parts/micro_laser/quadultra,
/obj/item/stock_parts/micro_laser/quadultra,
/obj/item/stock_parts/micro_laser/quadultra,
/obj/item/stock_parts/manipulator/femto,
/obj/item/stock_parts/manipulator/femto,
/obj/item/stock_parts/manipulator/femto,
/obj/item/stock_parts/manipulator/femto,
/obj/item/stock_parts/manipulator/femto,
/obj/item/stock_parts/manipulator/femto,
/obj/structure/rack,
/turf/open/floor/iron/dark/textured_large,
/area/ruin/syndicate_lava_base/testlab)
"hJ" = (
/obj/machinery/atmospherics/pipe/smart/manifold4w/cyan/visible,
/turf/open/floor/catwalk_floor/iron_dark,
/area/ruin/syndicate_lava_base/testlab)
"hK" = (
/obj/effect/spawner/structure/window/reinforced/plasma/plastitanium,
/obj/machinery/door/poddoor{
	id = "lavalandsyndi_mistake"
	},
/turf/open/floor/plating,
/area/ruin/syndicate_lava_base/testlab)
"iQ" = (
/obj/structure/sign/warning/explosives/alt/directional/south,
/obj/machinery/atmospherics/pipe/smart/manifold4w/green/visible,
/turf/open/floor/engine,
/area/ruin/syndicate_lava_base/testlab)
"js" = (
/turf/open/floor/engine,
/area/ruin/syndicate_lava_base/testlab)
"kE" = (
/turf/open/floor/iron/dark,
/area/ruin/syndicate_lava_base/testlab)
"kP" = (
/obj/effect/turf_decal/stripes/line,
/obj/machinery/power/energy_accumulator/tesla_coil/anchored,
/obj/structure/cable/multilayer/connected,
/turf/open/floor/engine,
/area/ruin/syndicate_lava_base/testlab)
"lq" = (
/obj/machinery/atmospherics/components/unary/vent_pump/on,
/turf/open/floor/iron/dark/smooth_large,
/area/ruin/syndicate_lava_base/testlab)
"lR" = (
/obj/effect/turf_decal/stripes/line{
	dir = 6
	},
/obj/machinery/power/energy_accumulator/grounding_rod/anchored,
/obj/structure/cable/multilayer/connected,
/turf/open/floor/engine,
/area/ruin/syndicate_lava_base/testlab)
"me" = (
/obj/machinery/atmospherics/pipe/smart/manifold4w/cyan/visible,
/turf/open/floor/engine,
/area/ruin/syndicate_lava_base/testlab)
"ol" = (
/obj/machinery/firealarm/directional/east,
/obj/structure/closet/radiation,
/obj/effect/turf_decal/trimline/dark_red/warning{
	dir = 4
	},
/obj/effect/turf_decal/trimline/dark_red/warning{
	dir = 8
	},
/turf/open/floor/iron/dark/textured,
/area/ruin/syndicate_lava_base/testlab)
"on" = (
/obj/machinery/door/firedoor,
/obj/machinery/atmospherics/pipe/smart/manifold4w/supply/hidden,
/obj/machinery/atmospherics/pipe/smart/manifold4w/scrubbers/hidden/layer4,
/obj/effect/mapping_helpers/airlock/access/all/syndicate/general,
/obj/effect/turf_decal/tile/neutral/fourcorners,
/obj/modular_map_connector,
/obj/structure/cable,
/obj/machinery/door/airlock/engineering{
	name = "Supermatter"
	},
/turf/open/floor/iron/dark/textured_large,
/area/ruin/syndicate_lava_base/testlab)
"oo" = (
/obj/machinery/atmospherics/pipe/smart/manifold4w/scrubbers/visible,
/obj/machinery/power/energy_accumulator/tesla_coil/anchored,
/obj/structure/cable/multilayer/connected,
/turf/open/floor/engine,
/area/ruin/syndicate_lava_base/testlab)
"oV" = (
/obj/structure/window/reinforced/plasma/spawner,
/obj/structure/window/reinforced/plasma/spawner/west,
/obj/machinery/atmospherics/components/unary/vent_pump/on{
	dir = 8
	},
/turf/open/floor/engine,
/area/ruin/syndicate_lava_base/testlab)
"oW" = (
/obj/structure/rack,
/obj/structure/railing,
/obj/item/storage/toolbox/syndicate,
/obj/item/pipe_dispenser,
/obj/item/rpd_upgrade/unwrench,
/obj/machinery/door/firedoor/border_only,
/turf/open/floor/plating,
/area/ruin/syndicate_lava_base/testlab)
"qb" = (
/obj/effect/turf_decal/caution/stand_clear/red,
/turf/open/floor/engine,
/area/ruin/syndicate_lava_base/testlab)
"qY" = (
/obj/machinery/atmospherics/pipe/smart/manifold4w/cyan/visible,
/obj/effect/turf_decal/stripes/line{
	dir = 8
	},
/obj/structure/cable/layer3,
/turf/open/floor/engine,
/area/ruin/syndicate_lava_base/testlab)
"rT" = (
/obj/effect/turf_decal/stripes/line,
/obj/structure/cable/layer3,
/obj/effect/turf_decal/stripes/red/line,
/obj/effect/turf_decal/arrows/red{
	dir = 1
	},
/turf/open/floor/engine,
/area/ruin/syndicate_lava_base/testlab)
"rX" = (
/obj/machinery/atmospherics/components/unary/passive_vent,
/obj/structure/lattice/catwalk,
/turf/template_noop,
/area/ruin/syndicate_lava_base/testlab)
"sa" = (
/obj/machinery/atmospherics/pipe/smart/manifold4w/scrubbers/visible,
/turf/closed/wall/mineral/plastitanium/nodiagonal,
/area/ruin/syndicate_lava_base/testlab)
"uG" = (
/obj/structure/cable,
/obj/effect/turf_decal/tile/neutral/half{
	dir = 1
	},
/turf/open/floor/iron/dark/smooth_half,
/area/ruin/syndicate_lava_base/testlab)
"uT" = (
/obj/machinery/atmospherics/components/unary/portables_connector/visible{
	dir = 4
	},
/obj/machinery/portable_atmospherics/canister/nitrogen,
/obj/effect/turf_decal/tile/red{
	dir = 1
	},
/turf/open/floor/iron/dark/textured,
/area/ruin/syndicate_lava_base/testlab)
"xD" = (
/obj/machinery/atmospherics/pipe/smart/manifold4w/supply/hidden,
/turf/open/floor/catwalk_floor/iron_dark,
/area/ruin/syndicate_lava_base/testlab)
"xI" = (
/obj/effect/turf_decal/tile/neutral/half,
/turf/open/floor/iron/dark/smooth_half,
/area/ruin/syndicate_lava_base/testlab)
"xT" = (
/obj/effect/turf_decal/stripes/line{
	dir = 10
	},
/obj/structure/cable/multilayer/connected,
/obj/machinery/power/terminal,
/turf/open/floor/engine,
/area/ruin/syndicate_lava_base/testlab)
"yO" = (
/obj/machinery/power/supermatter_crystal/shard/syndicate,
/obj/structure/window/reinforced/plasma/spawner,
/obj/machinery/atmospherics/components/unary/vent_pump/on{
	dir = 1
	},
/turf/open/floor/engine,
/area/ruin/syndicate_lava_base/testlab)
"Au" = (
/obj/machinery/atmospherics/components/unary/portables_connector/visible{
	dir = 4
	},
/obj/machinery/portable_atmospherics/canister/nitrogen,
/obj/machinery/light/directional/west,
/obj/effect/turf_decal/tile/red{
	dir = 8
	},
/turf/open/floor/iron/dark/textured,
/area/ruin/syndicate_lava_base/testlab)
"AS" = (
/obj/machinery/atmospherics/pipe/smart/manifold4w/scrubbers/visible,
/turf/open/floor/engine,
/area/ruin/syndicate_lava_base/testlab)
"AV" = (
/obj/structure/extinguisher_cabinet/directional/east,
/obj/machinery/atmospherics/pipe/smart/manifold4w/supply/hidden,
/obj/machinery/atmospherics/pipe/smart/manifold4w/scrubbers/hidden/layer4,
/obj/structure/cable,
/obj/effect/turf_decal/siding/dark_red{
	dir = 1
	},
/turf/open/floor/iron/dark,
/area/ruin/syndicate_lava_base/testlab)
"Ce" = (
/obj/structure/window/reinforced/plasma/spawner,
/obj/structure/window/reinforced/plasma/spawner/east,
/obj/machinery/atmospherics/components/unary/vent_scrubber/on{
	dir = 1
	},
/turf/open/floor/engine,
/area/ruin/syndicate_lava_base/testlab)
"CR" = (
/obj/structure/closet/radiation,
/obj/effect/turf_decal/trimline/dark_red/warning{
	dir = 4
	},
/obj/effect/turf_decal/trimline/dark_red/warning{
	dir = 8
	},
/turf/open/floor/iron/dark/textured,
/area/ruin/syndicate_lava_base/testlab)
"EC" = (
/obj/machinery/door/poddoor{
	id = "lavalandsyndi_mistake"
	},
/obj/effect/spawner/structure/window/reinforced/plasma/plastitanium,
/turf/open/floor/plating,
/area/ruin/syndicate_lava_base/testlab)
"GD" = (
/obj/item/stack/sheet/plasmarglass,
/obj/structure/window/reinforced/plasma/spawner,
/obj/machinery/atmospherics/pipe/smart/manifold4w/cyan/visible,
/turf/open/floor/engine,
/area/ruin/syndicate_lava_base/testlab)
"HC" = (
/obj/machinery/atmospherics/pipe/smart/manifold4w/supply/hidden,
/obj/machinery/airalarm/directional/south{
	req_access = list("syndicate")
	},
/turf/open/floor/catwalk_floor/iron_dark,
/area/ruin/syndicate_lava_base/testlab)
"It" = (
/obj/machinery/atmospherics/pipe/smart/manifold4w/green/visible,
/turf/closed/wall/mineral/plastitanium/nodiagonal,
/area/ruin/syndicate_lava_base/testlab)
"IG" = (
/obj/machinery/power/emitter/welded{
	dir = 1
	},
/obj/structure/cable,
/obj/structure/railing,
/obj/machinery/door/firedoor/border_only,
/turf/open/floor/plating,
/area/ruin/syndicate_lava_base/testlab)
"JO" = (
/obj/machinery/atmospherics/components/trinary/filter/on{
	dir = 1;
	filter_type = list(/datum/gas/nitrogen)
	},
/obj/structure/window/reinforced/plasma/spawner,
/turf/open/floor/engine,
/area/ruin/syndicate_lava_base/testlab)
"Lc" = (
/obj/machinery/atmospherics/components/binary/pump{
	dir = 4
	},
/turf/open/floor/iron/dark/textured,
/area/ruin/syndicate_lava_base/testlab)
"OI" = (
/obj/machinery/atmospherics/pipe/smart/manifold4w/green/visible,
/turf/open/floor/engine,
/area/ruin/syndicate_lava_base/testlab)
"Rn" = (
/obj/structure/cable/layer3,
/turf/open/floor/engine,
/area/ruin/syndicate_lava_base/testlab)
"Rp" = (
/obj/effect/turf_decal/stripes/line{
	dir = 4
	},
/turf/open/floor/engine,
/area/ruin/syndicate_lava_base/testlab)
"SU" = (
/turf/open/floor/iron/dark/smooth_half{
	dir = 1
	},
/area/ruin/syndicate_lava_base/testlab)
"Vo" = (
/obj/machinery/atmospherics/pipe/smart/manifold4w/green/visible,
/obj/machinery/atmospherics/pipe/bridge_pipe/scrubbers/visible{
	dir = 4
	},
/turf/open/floor/engine,
/area/ruin/syndicate_lava_base/testlab)
"Vp" = (
/obj/machinery/atmospherics/components/unary/vent_scrubber/on/layer4,
/obj/structure/cable,
/turf/open/floor/iron/dark/smooth_large,
/area/ruin/syndicate_lava_base/testlab)
"XN" = (
/obj/machinery/atmospherics/components/tank/nitrogen,
/obj/effect/turf_decal/stripes/line{
	dir = 6
	},
/obj/effect/turf_decal/stripes/red/line{
	dir = 9
	},
/turf/open/floor/iron/dark/textured,
/area/ruin/syndicate_lava_base/testlab)
"XS" = (
/obj/machinery/atmospherics/components/unary/thermomachine/freezer/on{
	dir = 1
	},
/turf/open/floor/engine,
/area/ruin/syndicate_lava_base/testlab)
"Yj" = (
/obj/effect/turf_decal/stripes/line{
	dir = 8
	},
/obj/machinery/atmospherics/pipe/color_adapter,
/turf/open/floor/engine,
/area/ruin/syndicate_lava_base/testlab)
"Ys" = (
/obj/effect/turf_decal/stripes/line{
	dir = 8
	},
/obj/structure/cable/layer3,
/turf/open/floor/engine,
/area/ruin/syndicate_lava_base/testlab)
"Zg" = (
/obj/machinery/power/smes,
/obj/structure/railing,
/obj/structure/cable,
/obj/machinery/door/firedoor/border_only,
/turf/open/floor/plating,
/area/ruin/syndicate_lava_base/testlab)
"ZR" = (
/obj/machinery/firealarm/directional/east,
/obj/machinery/atmospherics/pipe/smart/manifold4w/green/visible,
/turf/open/floor/engine,
/area/ruin/syndicate_lava_base/testlab)

(1,1,1) = {"
aA
aA
aA
aA
aA
aA
aA
aA
em
em
aA
aA
aA
"}
(2,1,1) = {"
aA
aA
em
em
em
em
em
em
em
eZ
gJ
aA
aA
"}
(3,1,1) = {"
aA
em
em
uT
Au
dO
XN
kE
eq
lq
xD
aA
aA
"}
(4,1,1) = {"
em
em
gX
Lc
Lc
hJ
SU
SU
em
xI
HC
aA
aA
"}
(5,1,1) = {"
em
bs
Yj
qY
qY
qY
Ys
xT
Zg
uG
aU
aA
aA
"}
(6,1,1) = {"
hK
OI
XS
fY
GD
oV
js
kP
oW
bp
xD
be
aA
"}
(7,1,1) = {"
EC
OI
XS
Rn
me
yO
qb
rT
IG
Vp
ef
AV
on
"}
(8,1,1) = {"
em
OI
AS
oo
JO
Ce
Rp
lR
em
ol
CR
aA
aA
"}
(9,1,1) = {"
em
It
Vo
ZR
iQ
em
aA
aA
aA
aA
aA
aA
aA
"}
(10,1,1) = {"
rX
sa
sa
em
em
em
aA
aA
aA
aA
aA
aA
aA
"}
